{
    "ver": "2.3",
    "ref": "251004-3f70cb03-2906-4b9f-9522-cc5fc748436a",
    "log": [ [ [ 0, 0, 0 ],
        [ 25000, 25000, 25000, 25000 ],
        [ 34 ],
        [ 38 ],
        [ 46, 36, 39, 44, 32, 13, 29, 45, 33, 16, 26, 21, 21 ],
        [ 42, 24, 11, 11, 26, 17, 15, 46, 12, 45, 37, 28, 34, 51, 43 ],
        [ 44, 29, 39, 45, 46, 26, 21, 21, 42, 46, 12, 13, 28, 45, 60 ],
        [ 24, 14, 16, 45, 22, 29, 23, 23, 27, 17, 28, 12, 11 ],
        [ 46, 22, 16, 31, 19, 41, 35, 39, 25, 35, 42, 37, 21, 52, 18 ],
        [ 11, 46, 45, 60, 60, 60, 12, 60, 14, 16, 60, 60, "r25", 60 ],
        [ 39, 27, 27, 13, 17, 25, 15, 44, 12, 29, 32, 32, 43 ],
        [ 28, 42, 25, 44, 33, 18, 47, 23, 13, 34, 27, 18, 45 ],
        [ 44, 39, 42, 60, 43, 15, 60, 27, 32, 13, 60, 25, 60 ],
        [ 14, 14, 47, 32, 26, 41, 16, 37, 53, 43, 24, 34, 22 ],
        [ 35, 47, 12, 18, 19, 39, "p474747", 22, "14p1414", 17, 47, 38, 26, 23 ],
        [ 43, 41, 32, 12, 60, 60, 18, 26, 16, 60, 24, 47, 60, 60 ],
        [ "和了", [ -4000, 9000, -2000, -2000 ],
        [ 1, 1, 1, "Mangan 2000-4000点", "Fully Concealed Hand(1飜)", "Pinfu(1飜)", "Riichi(1飜)", "Dora(2飜)", "Ura Dora(0飜)" ] ] ],
        [ [ 1, 0, 0 ],
        [ 21000, 33000, 23000, 23000 ],
        [ 33 ],
        [ 12 ],
        [ 39, 26, 17, 17, 32, 38, 33, 46, 11, 43, 22, 31, 12 ],
        [ 28, 41, 24, 34, 32, 45 ],
        [ 43, 60, 12, 46, 39, 38 ],
        [ 34, 46, 44, 12, 13, 39, 42, 35, 11, 17, 37, 37, 36 ],
        [ 38, 43, 29, 18, 14, 14, 13 ],
        [ 46, 60, 60, 42, 44, "r37", 60 ],
        [ 31, 24, 52, 14, 18, 38, 27, 23, 19, 15, 37, 39, 11 ],
        [ 19, 28, 25, 29, 36, 35 ],
        [ 11, 31, 60, "r18", 60, 60 ],
        [ 43, 11, 32, 16, 45, 37, 28, 47, 29, 39, 44, 27, 22 ],
        [ 21, 46, 24, 14, 16, 47 ],
        [ 44, 43, 11, 46, 47, 37 ],
        [ "和了", [ 0, -7700, 9700, 0 ],
        [ 2, 1, 2, "30符4飜7700点", "Pinfu(1飜)", "Riichi(1飜)", "Red Five(1飜)", "Ura Dora(1飜)" ] ] ],
        [ [ 2, 0, 0 ],
        [ 21000, 24300, 31700, 23000 ],
        [ 41 ],
        [],
        [ 17, 21, 36, 43, 28, 34, 43, 45, 13, 14, 38, 23, 14 ],
        [ 27, 19, 19, 35, 41, 46, 39, 25, 21 ],
        [ 45, 21, 23, 14, 60, 60, 60, 60, 60 ],
        [ 45, 37, 25, 26, 32, 17, 53, 19, 34, 38, 42, 14, 52 ],
        [ 39, 38, 29, 37, 45, 35, 32 ],
        [ 45, 32, 60, 42, 60, 14, 60 ],
        [ 26, 31, 41, 16, 31, 16, 12, 51, 26, 27, 36, 47, 11 ],
        [ 47, 11, 36, 31, 42, 43, 32, 28 ],
        [ 12, 36, 60, 41, 60, 60, 60, 60 ],
        [ 46, 34, 17, 46, 24, 44, 25, 12, 23, 21, 26, 31, 12 ],
        [ 22, 22, 39, 27, 18, 21, "4646p46", 35, "c282627" ],
        [ 31, 34, 60, 17, 60, 12, 12, 60, 44 ],
        [ "和了", [ -3900, 0, 0, 3900 ],
        [ 3, 0, 3, "30符3飜3900点", "Half Flush(2飜)", "Green Dragon(1飜)" ] ] ],
        [ [ 3, 0, 0 ],
        [ 17100, 24300, 31700, 26900 ],
        [ 37 ],
        [ 13 ],
        [ 38, 46, 42, 19, 33, 29, 33, 12, 36, 41, 47, 34, 24 ],
        [ 31, 43, 41, 14, 43, 18, 11, 22, 17 ],
        [ 29, 24, 12, 60, 19, 31, 60, 46, 18 ],
        [ 27, 51, 13, 26, 15, 46, 16, 33, 23, 44, 23, 13, 31 ],
        [ 37, 44, 12, 24, 24, 37, 53, 45, 39 ],
        [ 44, 60, 46, 15, 31, 23, 23, 12, 45 ],
        [ 47, 36, 25, 38, 25, 32, 52, 31, 28, 27, 23, 11, 34 ],
        [ 35, 32, 22, 32, 21, 12, 45, 18, 27 ],
        [ 47, 11, 31, 28, "r38", 60, 60, 60 ],
        [ 47, 29, 25, 44, 39, 33, 16, 26, 18, 26, 22, 19, 21 ],
        [ 21, 43, 45, 36, 19, 46, 24, 21, 29 ],
        [ 19, 44, 43, 29, 39, 47, 46, 45, 18 ],
        [ "和了", [ -1300, -1300, 6200, -2600 ],
        [ 2, 2, 2, "40符3飜1300-2600点", "Fully Concealed Hand(1飜)", "Riichi(1飜)", "Red Five(1飜)", "Ura Dora(0飜)" ] ] ],
        [ [ 4, 0, 0 ],
        [ 15800, 23000, 36900, 24300 ],
        [ 32 ],
        [],
        [ 17, 47, 32, 42, 47, 27, 21, 32, 17, 28, 21, 11, 26 ],
        [ 13, 23, 41, 34, 29, "32p3232", 45, 23, 42, 47, 43, 33 ],
        [ 60, 60, 60, 42, 34, 26, 60, 60, 60, 11, 60, 60 ],
        [ 26, 13, 19, 29, 27, 11, 26, 14, 13, 16, 37, 41, 18 ],
        [ 14, 43, 33, 31, 36, 25, 52, 42, 35, 38, 12, 22 ],
        [ 29, 60, 41, 19, 26, 31, 11, 60, 13, 13, 60, 60 ],
        [ 46, 28, 16, 34, 32, 18, 27, 31, 34, 23, 46, 35, 39 ],
        [ 36, 31, 45, 29, 53, 34, 22, 39, 43, 27, 12, 35 ],
        [ 39, 23, 60, 31, 32, 31, 60, 60, 60, 60, 60, 18 ],
        [ 37, 31, 13, 24, 36, 45, 29, 41, 37, 23, 12, 21, 18 ],
        [ 14, 21, 24, 26, 22, 24, 43, 39, 42, 11, 17 ],
        [ 41, 31, 29, 45, 18, 37, 60, 60, 60, 60, 21 ],
        [ "和了", [ 2000, 0, 0, -2000 ],
        [ 0, 3, 0, "40符1飜2000点", "Red Dragon(1飜)" ] ] ],
        [ [ 4, 1, 0 ],
        [ 17800, 23000, 36900, 22300 ],
        [ 13 ],
        [ 42 ],
        [ 28, 17, 41, 32, 21, 14, 25, 39, 35, 31, 19, 17, 27 ],
        [ 28, 26, 24, 33, 38, 29, 33, 34, 12, 21, 32, 33 ],
        [ 21, 39, 32, 31, 60, 19, 41, 33, 28, "r60", 60, 60 ],
        [ 33, 31, 39, 26, 47, 34, 12, 22, 21, 38, 41, 41, 24 ],
        [ 22, 31, 22, 27, 37, 11, 15, 47, 31, 43, 18, 29 ],
        [ 31, 60, 21, 47, 12, 60, 60, 60, 60, 41, 41, 24 ],
        [ 26, 27, 44, 24, 38, 37, 45, 19, 36, 43, 35, 22, 52 ],
        [ 42, 15, 16, 11, 19, 34, 17, 34, 26, 41, 24, 28 ],
        [ 44, 19, 43, 60, 60, 42, 45, 38, "r22", 60, 60 ],
        [ 46, 42, 14, 45, 25, 47, 44, 32, 23, 23, 21, 13, 45 ],
        [ 19, 43, 45, 14, 13, 35, 17, 12, 18, 53, 47 ],
        [ 60, 60, 44, 42, 47, 32, 46, 17, 45, 21, 60 ],
        [ "和了", [ -4100, -2100, 10300, -2100 ],
        [ 2, 2, 2, "Mangan 2000-4000点", "All Simples(1飜)", "Fully Concealed Hand(1飜)", "Pinfu(1飜)", "Riichi(1飜)", "Red Five(1飜)", "Ura Dora(0飜)" ] ] ],
        [ [ 5, 0, 0 ],
        [ 12700, 20900, 46200, 20200 ],
        [ 12 ],
        [],
        [ 41, 23, 24, 45, 35, 22, 31, 47, 33, 29, 34, 16, 41 ],
        [ 18, 36, 11, 13, 33, 41, 45, 21, 43, 34 ],
        [ 29, 45, 47, 18, 41, 41, 31, 41, 60, 45 ],
        [ 18, 51, 28, 46, 24, 44, 24, 21, 45, 37, 37, 32, 19 ],
        [ 11, 29, 19, 31, 11, 23, 15, 26, 33, 38, 42 ],
        [ 44, 21, 11, 29, 60, 18, 45, 60, 31, 23, 33 ],
        [ 26, 43, 14, 32, 53, 17, 12, 14, 16, 24, 28, 39, 27 ],
        [ 32, 31, 15, 41, 47, 38, 15, 22, 25, "c232425", 29 ],
        [ 43, 39, 12, 60, 60, 60, 31, 60, 15, 53, 60 ],
        [ 44, 42, 19, 34, 13, 32, 22, 36, 39, 42, 35, 26, 45 ],
        [ 29, 44, 25, 46, 37, 27, 11, 43, 28, "c533637", 34 ],
        [ 60, 19, 39, 22, 45, 46, 60, 60, 60, 13, 32 ],
        [ "和了", [ 0, 0, 1000, -1000 ],
        [ 2, 3, 2, "30符1飜1000点", "All Simples(1飜)" ] ] ],
        [ [ 6, 0, 0 ],
        [ 12700, 20900, 47200, 19200 ],
        [ 18 ],
        [],
        [ 41, 33, 16, 13, 11, 16, 39, 46, 21, 17, 38, 28, 47 ],
        [ 28, 34, 17, 29, 53, 45, 18, 22 ],
        [ 41, 21, 46, 60, 38, 39, 47, 45 ],
        [ 41, 42, 27, 39, 34, 16, 32, 22, 17, 23, 14, 23, 31 ],
        [ 47, 13, 43, 33, 36, 36, 52 ],
        [ 39, 41, 42, 43, 47, 31, 27 ],
        [ 32, 37, 15, 26, 44, 39, 11, 19, 13, 28, 27, 24, 17 ],
        [ 43, 12, 37, 12, 43, 35, 46 ],
        [ 44, 43, 32, 60, 60, 39, 60 ],
        [ 11, 45, 47, 12, 21, 37, 23, 26, 24, 45, 38, 34, 42 ],
        [ 42, 15, 51, "42p4242", 29, 13, "c393738", 26 ],
        [ 21, 47, 26, 34, 60, 24, 23, 60 ],
        [ "和了", [ -7700, 0, 0, 7700 ],
        [ 3, 0, 3, "30符4飜7700点", "White Dragon(1飜)", "Prevalent Wind(1飜)", "Seat Wind(1飜)", "Red Five(1飜)" ] ] ],
        [ [ 7, 0, 0 ],
        [ 5000, 20900, 47200, 26900 ],
        [ 31 ],
        [ 47 ],
        [ 37, 27, 34, 32, 43, 22, 46, 46, 45, 15, 11, 47, 25 ],
        [ 36, 44, 17, 15, 24, 19, 52, 28, 28, 39, 43, 15, 32, 29, 38, 41, 22 ],
        [ 11, 22, 15, 60, 17, 60, 44, 43, 45, 60, 60, 60, 46, 46, 47, 60, 60 ],
        [ 19, 34, 14, 35, 24, 46, 13, 31, 23, 29, 13, 51, 42 ],
        [ 33, 42, 11, 46, 41, 16, 16, 41, 24, 16, 12, 16, 23, 23, 12, 37 ],
        [ 42, 60, 46, 60, 60, 29, 19, 60, 31, 11, 24, "r12", 60, 60, 60, 60 ],
        [ 53, 44, 25, 32, 27, 38, 26, 18, 26, 39, 43, 33, 36 ],
        [ 43, 36, 31, 42, 12, 21, 35, 22, 12, 41, 17, 45, 47, 42, 24, 37 ],
        [ 44, 18, 36, 60, 60, 60, 60, 60, 60, 60, 60, 43, 43, 60, 45, 47 ],
        [ 13, 33, 21, 36, 39, 25, 17, 28, 18, 31, 22, 44, 13 ],
        [ 39, 14, 47, 28, 26, 21, 14, 17, 23, 29, 44, "p171717", 35, 18, 45, 21, 37 ],
        [ 44, 28, 60, 60, 21, 22, 21, 36, 60, 60, 60, 18, 31, 60, 60, 60, 60 ],
        [ "和了", [ -5200, 6200, 0, 0 ],
        [ 1, 0, 1, "40符3飜5200点", "All Simples(1飜)", "Riichi(1飜)", "Red Five(1飜)", "Ura Dora(0飜)" ] ] ] ],
    "ratingc": "PF4",
    "rule": { "disp": "Jade Room South", "aka53": 1, "aka52": 1, "aka51": 1 },
    "lobby": 0,
    "dan": [ "Master I", "Saint I", "Master I", "Master I" ],
    "rate": [ 1634, 1480, 609, 1264 ],
    "sx": [ "F", "F", "F", "F" ],
    "name": [ "腰痛プロ", "pokorou", "过气少女萝卜花", "小地鼠爱点炮" ],
    "sc": [ -200, -40.2, 26100, -3.9, 47200, 37.2, 26900, 6.9 ],
    "title": [ "Jade Room South", "10/4/2025, 5:23:53 PM" ]
}